00000000000000000000000000000000000000000000000000000000000000000000000000000000
00000000000000000000000000000000000000000000000000000000000000000000000000000000
00000000000000000000000000000000000000000000000000000000000000000000000000000000
00011111111111111111111111111111111111111111111111111111111111111111111111111000
00011111111111111111111111111111111111111111111111111111111111111111111111111000
00011111111111111111111111111111111111111111111111111111111111111111111111111000
00011111111111111111111111111111111111111111111111111111111111111111111111111000
00011111111111111111111111111111111111111111111111111111111111111111111111111000
00011111111111111111111111111111111111111111111111111111111111111111111111111000
00011111111111111111111111111111111111111111111111111111111111111111111111111000
00011111111111111111111111111111111111111111111111111111111111111111111111111000
00000000000000000000000000000000000111111111100000000000000000111111111111111000
00000000000000000000000000000000000111111111100000000000000000111111111111111000
00011111111111111111111111111111111111111111111111111111100000011111111111111000
00011111111111111111111111111111111111111111111111111111100000001111111111111000
00011111111111111111111111111111111111111111111111111111111000000001111111111000
00011111111111111111111111111111111111111111111111111111111000000001111111111000
00011111111111111111111111111111111111111111111111111111111111111111111111111000
00011111111111111111111111111111111111111111111111111111111111111111111111111000
00011111111111111111111111111111111111111111111111111111111111111111111111111000
00011111111111111111111111111111111111111111111111111111111111111111111000000000
00011111111111111111111111111111111111111111111111111111111111111111111000000000
00011111111111111111111111111111111111111111111111111111111111111111111000000000
00011111111111111111111111111111111111111111111111111111111111111111111000000000
00011111111111111111111111111111111111111111111111111111111111111111111000000000
00011111111111111111111111111111111111111111111111111111111111111111111000000000
00011111111111111111110000000111111111111111111111111111111111111110000000000000
00011111111111111111111111111111111111111111111111110000001111111110000000000000
00011111111111111111111111111111111111111111111111111111111111111110000000000000
00011111111111111111111111111111111000000000000111111111111111111110000000000000
00011111111111111111111111111111111000000000000111111111111111111110000000000000
00011111111110000111111111111111110000000000000011111111111110000000000000000000
00011111111110000000000000000000000000000000000000000000000000000000000000000000
00011111111111111111111111111111111111111111111111111111111111111111111111111000
00011111111111111111111111111111111111111111111111111111111111111111111111111000
00000000011111111111111111111111111111111111111111111111111111111111111111111000
00000000011111111111111111111111111111111111111111111111111111111111111111111000
00000000011111111111111111111111111111111111111111111111111111111111111111111000
00000000011111111111111111111111111111111111111111111111111111111111111111111000
00000000011111111111111111111111111111111111111111111111111111111111111111111000
00000000011111111111111111111111111111111111111111111111111111111111111111111000
00000000000000000000000000000000000000000000000000000000000000000000001111111000
00000000000000000000000000000000000000000000000000000000000000000000001111111000
00011111111111111111111111111111111111111111111111111111111111111111111111111000
00011111111111111111111111111111111111111111111111111111111111111111111111111000
00011111111111111111111111111111111111111111111111111111111111111111111111111000
00011111111111111111111111111111111111111111111111111111111111111111111111111000
00011111111111111111111111111111111111111111111111111111111111111111111111111000
00011111111111111111111111111111111111111111111111111111111111111111111111111000
00011111111111111111111111111111111111111111111111111111111111111111111111111000
00011111111111111111111111111111111111111111111111111111111111111111111111111000
00011111111111111111111111111111111111111111111111111111111111111111111000000000
00011111111110000000000000000001111111111111100000000000000000011111111000000000
00011111111111111111111111111111111111111111111111111111111111111111111000000000
00011111111111111111111111111111111111111111111111111111111111111111111000000000
00011111111111111111111111111111111111111111111111111111111111111111111000000000
00011111111111111111111111111111111111111111111111111111111111111111111000000000
00011111111111111111111111111111111111111111111111111111111111111111111000000000
00000000000000000000000000000000000000000000000000000000000000000000000000000000
00000000000000000000000000000000000000000000000000000000000000000000000000000000