11111111111111111111111111111111111111111111111111111111111111111111111111111111
11111111111111111111111111111111111111111111111111111111111111111111111111111111
11000000000000000000000000000000000000000000000000000000000000000000000000000011
11000000000000000000000000000000000000000000000000000000000000000000000000000011
11000000000000000000000000000000000000000000000000000000000000000000000000000011
11000000000000000000000000000000000000000000000000000000000000000000000000000011
11000000000000000000000000000000000000000000000000000000000000000000000000000011
11000000000000000000000000000000000000000000000000000000000000000000000000000011
11000000000000000000001111100000000000000000000000000000000000000000000000000011
11000000000000000000011111110000000000000000000000000000000000000000000000000011
11000000000000000000001111111111000000000000000000000000000000000000000000000011
11000000000000000000001111111111111000000000000000000000000000000000000000000011
11000000000000000000000001111111111111111111111111111111111111111111111111111111
11000000000000000000000001111111111111111111111111111111111111111111111111111111
11000000000000000000000001111111111000000000000000000000000000000000000000000011
11111111111100000000000001111111111000000000000000000000000000000000000000000011
11111111111100000000000001111111111000000000000000000000000000000000000000000011
11111111111100000000000001111111111000000000000000000000000000000000000000000011
11111111111100000000000000000000000000000000000000000000000000000000000000000011
11111111111100000000000000000000000000000111111111111111100000000000000000000011
11111111111100000000000000000000000000000111111111111111110000000000000000000011
11111111111100000000000000000000000000000111111111111111111000000000000000000011
11111111111100000000000000000000000000000111111111111111111100000000000000000011
11111111111111111111111111111111111111111111111111111111111111111111110000000011
11111111111111111111111111111111111111111111111111111111111111111111110000000011
11000000000000000000000000000000000000000000000000000000001111111111110000000011
11000000000000000000000000000000000000000000000000000000001111111111110000000011
11000000000000000000000000000000000000000000000000000000000000000000000000000011
11000000000000000000000000000000000000000000000000000000000000000000000000000011
11000000000000000000000000000000000000000000000000000000000000000000000000000011
11000000000000000000000000000000000000000000000000000000000000000000000000000011
11000000001111111111111111111111111111111100000000000000000000000000000000000011
11000000001111111111111111111111111111111110000000000000000000000000000000000011
11000000000000000000000000000000000001111111111111111111111111111111111111111111
11000000000000000000000000000000000000111111111110000000111111111111111111111111
11000000000000000000000000000000000000000000000000000000000000000011111111111111
11000000000000000000000000000000000000000000000000000000000000000001111111111111
11000000000000000000000000000000000000000000000000000000000000000000111111111111
11000000000000000000000000000000000000000000000000000000000000000000000111111111
11000000000000000000000000000000000000000000000000000000000000000000000011111111
11000000000000000000000000000000000000000000000000000000000000000000000001111111
11111111111111111111111111111111111100000000000000000000000000000000000000111111
11111111111111111111111111111111111110000000000000000000000000000000000000000011
11111111111111111111111111111111111111000000000000000000000000000000000000000011
11000000000000000000000000000000111111100000000000000000000000000000000000000011
11000000000000000000000000000000011111111000000000000000000000000000000000000011
11000000000000000000000000000000001111111111111111111111111111111110000000000011
11000000000000000000000000000000000000000000000000000000000000000000000000000011
11000000000000000000000000000000000000000000000000000000000000000000000000000011
11000000000000000000000000000000000000000000000000000000000000000000000000000011
11111111111111111111111111100000000000000000000000000000000000000000000000000011
11111111111111111111111111100000000000000000000000000000000000000000000000000011
11000000000000000000000000000000000000000000000000000000000000000000000000111111
11000000000000000000000000000000000000000000000000000000000000000000000001111111
11000000000000000000000000000000000000000000000000000000000000000000000011111111
11000000000000000000000000000000000000000000000000000000000000000000000011111111
11000000000000000000000000000000000000000000000000000000000000000000000011111111
11000000000000000000000000000000000000000000000000000000000000000000000011111111
11111111111111111111111111111111111111111111111111111111111111111111111111111111
11111111111111111111111111111111111111111111111111111111111111111111111111111111