11111111111111111111111111111111111111111111111111111111111111111111111111111111
11111111111111111111111111111111111111111111111111111111111111111111111111111111
11111111111111111111111111111111111111111111111111111111111111111111111111111111
11100000000000000000000000000000000000000000000000000000000000000000000000000111
11100000000000000000000000000000000000000000000000000000000000000000000000000111
11100000000000000000000000000000000000000000000000000000000000000000000000000111
11100000000000000000000000000000000000000000000000000000000000000000000000000111
11100000000000000000000000000000000000000000000000000000000000000000000000000111
11100000000000000000000000000000000000000000000000000000000000000000000000000111
11100000000000000000000000000000000000000000000000000000000000000000000000000111
11100000000000000000000000000000000000000000000000000000000000000000000000000111
11111111111111111111111111111111111000000000011111111111111111000000000000000111
11111111111111111111111111111111111000000000011111111111111111000000000000000111
11100000000000000000000000000000000000000000000000000000011111100000000000000111
11100000000000000000000000000000000000000000000000000000011111110000000000000111
11100000000000000000000000000000000000000000000000000000000111111110000000000111
11100000000000000000000000000000000000000000000000000000000111111110000000000111
11100000000000000000000000000000000000000000000000000000000000000000000000000111
11100000000000000000000000000000000000000000000000000000000000000000000000000111
11100000000000000000000000000000000000000000000000000000000000000000000111111111
11100000000000000000000000000000000000000000000000000000000000000000000111111111
11100000000000000000000000000000000000000000000000000000000000000000000111111111
11100000000000000000000000000000000000000000000000000000000000000000000111111111
11100000000000000000000000000000000000000000000000000000000000000000000111111111
11100000000000000000000000000000000000000000000000000000000000000000000111111111
11100000000000000000000000000000000000000000000000000000000000000001111111111111
11100000000000000000001111111000000000000000000000000000000000000001111111111111
11100000000000000000000000000000000000000000000000001111110000000001111111111111
11100000000000000000000000000000000000000000000000000000000000000001111111111111
11100000000000000000000000000000000111111111111000000000000000000001111111111111
11100000000000000000000000000000000111111111111000000000000000000001111111111111
11100000000001111000000000000000001111111111111100000000000001111111111111111111
11100000000001111111111111111111111111111111111111111111111111111111111111111111
11100000000000000000000000000000000000000000000000000000000000000000000000000111
11100000000000000000000000000000000000000000000000000000000000000000000000000111
11111111100000000000000000000000000000000000000000000000000000000000000000000111
11111111100000000000000000000000000000000000000000000000000000000000000000000111
11111111100000000000000000000000000000000000000000000000000000000000000000000111
11111111100000000000000000000000000000000000000000000000000000000000000000000111
11111111100000000000000000000000000000000000000000000000000000000000000000000111
11111111100000000000000000000000000000000000000000000000000000000000000000000111
11111111111111111111111111111111111111111111111111111111111111111111110000000111
11111111111111111111111111111111111111111111111111111111111111111111110000000111
11100000000000000000000000000000000000000000000000000000000000000000000000000111
11100000000000000000000000000000000000000000000000000000000000000000000000000111
11100000000000000000000000000000000000000000000000000000000000000000000000000111
11100000000000000000000000000000000000000000000000000000000000000000000000000111
11100000000000000000000000000000000000000000000000000000000000000000000000000111
11100000000000000000000000000000000000000000000000000000000000000000000000000111
11100000000000000000000000000000000000000000000000000000000000000000000000000111
11100000000000000000000000000000000000000000000000000000000000000000000000111111
11100000000000000000000000000000000000000000000000000000000000000000000001111111
11100000000001111111111111111110000000000000011111111111111111100000000011111111
11100000000000000000000000000000000000000000000000000000000000000000000111111111
11100000000000000000000000000000000000000000000000000000000000000000000111111111
11100000000000000000000000000000000000000000000000000000000000000000000111111111
11100000000000000000000000000000000000000000000000000000000000000000000111111111
11100000000000000000000000000000000000000000000000000000000000000000000111111111
11111111111111111111111111111111111111111111111111111111111111111111111111111111
11111111111111111111111111111111111111111111111111111111111111111111111111111111